##########################
#CCCCC*CCCCCCC#S#CCC#CCCC#
#C#############L###L#C####
#CCCCCCCCCCCCCCCCCCC#C####
##C####C#####CCCCC#C#C####
##CCC##C#####CC*CC#CCCC*C#
##C#C##*##*##CCCCC#L######
##C#C##C#####CCCCC#C#CCCC#
##*################C#*####
##CCL#GLCCC*CCCCCCCC#C####
##C########C#######C#C####
#CCCCCCCCC#C#CCC#CCLCC##C#
#CCCCCCLCC#C#C#C#CCCCC#CC#
#CCC*CCCCC#C#CCC#CC#CC#C##
#CCCCCCCCCCC##*CCCCCCC#CC#
#CLCCC*CCC#CC#C#########C#
#CCCCCCCCC#C##*CCCCC*CCCC#
##########################