##########################
#CCCCCCCCCCLSLCCCCCCCCCCC#
#L######################L#
#///////////#////////////#
#///////////#////////////#
#///////////#////////////#
#*////*////*#//////L/////#
#///////////#////////////#
#///////////#////////////#
#///////////#////////////#
#///////////#////////////#
#*////*////*#//////L/////#
#///////////#////////////#
#///////////#////////////#
#///////////#*///////////#
#*////*////*#C/////L/////#
#//////////G#*///////////#
##########################