##########################
#..///////#/S/#////////..#
#..///////#/L/#////////..#
#C//////////////////////C#
#C//////////C///////////C#
#C//////////@///////////C#
#C//////////C///////////C#
#C//////////C///////////C#
#C//////////@///////////C#
#C//////////C///////////C#
#C//////////C///////////C#
#C//////////*///////////C#
#C////////CCCCC/////////C#
#C////////C###C/////////C#
#C////////C#*#C/////////C#
#C////////C#G#C/////////C#
#C////////CCCCC/////////C#
##########################